########################################################
#                           #               <          #
# ############### ######### # # ########## ########### #
# #             #         # # #                      # #
# # ########### # ####### # # ############ ######### # #
# # #           # #       # # #          #         # # #
# # # ########### ######### # # ######## # ####### # # #
# # # #                     # # #      # # #     # # # #
# # # # ##################### # # #### # # # ### # # # #
# # # # #         #         # # #    # # # #   # # # # #
# # # # # ####### # ####### # # #### # # # ### # # # # #
# # # # # #     #   #     #   #      # # #   # # # # # #
# # # # # # ### ##### ### ######### ## ##### # # # # # #
# # # # # # #                              # # # # # # #
# # # #   # # # ####### ###### ######### # # # # # # # #
# # # ##### # #                          # #   # # #   #
# # #       # # #### #### #### #### #### # ##### # ### #
# # # ####### # #### #### #### #### #### # #       ### #
#   #         #                          # # ######### $
############# # #### #### #### #### #### # #       ### #
#     #       # #### #### #### #### #### # ########### #
# ### # #####                            # #       #   #
#   # # #   ##### ############ ####### # # # ##### # # #
# # # # # #     #   #       #          #   # #   # # # #
# # # # # ##### # # # ##### # ###### # # ### ### # # # #
# # # # #     # # # #     # # #      # # #   # # # # # #
# # # # ##### # # # ##### # # # #### # # # ### # # # # #
# # # #       # # #     # # # #      # # #     # # # # #
# # # ######### # ##### # # # ######## # ####### # # # #
# # #           #       # # #          #         # # # #
# # # ################### # ###################### # # #
# # #                     #            #           # # #
# # ######################### ######## # ########### # #
# #                       #                          # #
# ############# ######### # ############ ############# #
#                                                      #
########################################################
