###############################
#                             #
# ########################### #
# # #             #         # #
# # # ##### ### # # # ##### # #
# # # #   # #   # # #     # # #
# #   # # # # ### # ##### # # #
# ### # # # #   #   #     # # #
#   # # # # ######### ### # # #
### # # # # #     #   #   # # #
#>  # # # # #    $  ### ### # #
### #     # #     #   #     # #
# # ####### ################# #
# #                 #       # #
# # ####### ####### # ##### # #
# #       #       # # #     # #
# ####### ####### # # # ##### #
#         #       # #         #
# ######### ####### ######### #
#         #                   #
###############################
