#############################################################
#  <# #   #       # # #   #     #       #   # #           # #
# ### ### ### # # # # # # ### # ####### ### # # # ##### ### #
#     #   #   # #       # #   #   #     #   # # #   #   #   #
# ##### ####### # # ########### # # ####### # # # # ### ### #
#   #   #       # #   # # #     # #   # # #   # # # # # #   #
# ##### ##### ####### # # # ##### # ### # ### # ### # # ### #
#           #     #   # # # # #   #         # # #     # #   #
### ### ####### ### # # # # # ### ####### # # ####### ##### #
#   #       # #   # # #   # #   # # #   # #   #     # # #   #
### ### ### # # # ### ### # # # ### # ### ####### ### # # # #
#   # # #       # #   # #   # # #   #         #         # # #
# ### ### ####### ##### # # # ### ### # # ### ### # # # ### #
# # #   #       #   # #   #   # #     # # #       # # #     #
# # # # # ####### ### # ##### # ####### ### ### ##### ### # #
#     # #     # # # #       # #   # #     # # # #   # #   # #
# ############# # # ##### # ##### # ####### # ##### ### # # #
#       # #     #         # #   # #       #       #   # # # #
### # # # ### ##### ### # # # ### # ##### # # ##### # # # # #
#   # #   #     #   # # # # #     # # #   # #     # # # # # #
# ##### ##### ##### # ######### ### # ### ##### ### ### #####
# #     #           #   # #   #     #       #   #     # # # #
# ### ### # # ### ### # # ### # ### ####### # # ##### # # # #
# # #   # # #   #     #   # #   #       #     # # #   #     #
### ######### ############# ### ### # # ### # # # # # ### ###
#     #             #     #     # # # #   # # #     # #   # #
# ####### ### # ### # ######### # ####### ### ####### ##### #
#   # #   #   # # # # #   #       # #   # #         # # #   #
### # # # ### # # ### # ##### ##### # ############### # # ###
#     # #   # #       # #       # #   #       # # # #   #   #
# # ### ### ### ####### # ### ### # # # ### # # # # ### # ###
# #   # # # #       #       # #     #   # # # #             #
### ### # # ### ############# ### ####### ### ##### ### #####
#         # #     # #     #   # #   # #   #     #   #       #
# # ### ######### # ### ##### # # ### # # ########### # # # #
# #   # #     # # #   # # #             # #       #   # # # #
# ######### ### ### ### # ##### ### ##### ####### # ##### ###
# # #   # #     #     #         #   # # #   #       #   # # #
# # ### # # # ####### # ### # ### ### # # # ##### ##### # # #
# # #       #     #     #   # #   # #   # #   #   #     #   #
# # ####### ### ##### # ### ### # # # ######### # # ####### #
#   #       #     #   # # # #   # #   #         #     #   # #
# # ### ######### # # # # ##### ### ####### # ### ####### # #
# #       #   #     # #     # # # # #     # # #         #   #
# ### # ### ### # ### # ##### # # # # ######### ### ####### #
# #   #   #   # #   # # #     #           #   # #   #       #
# # # # ### ######### ##### # ####### ### # # ##### ####### #
# # # # #     #       #     # #     # #     # #         #   #
# # ### # # ######### # ####### ######### ##### # ##### #####
# # #     #     # #   #   #     #       #   #   # #   # #   #
### ########### # # # # ### ### ##### # ### ######### # # ###
#   #     # # #   # #     #   # # #   #       #         # # #
### # ##### # ### # ### # ### # # ##### # ### # # ####### # #
# # #   # #     # # # # #   # # #     # #   # # # #   #     #
# # ### # # # # ##### # ### ### ### ##### ##### # ### ### ###
# #     # # # #           # # # #             # #       #   #
# ##### # ##### ####### ##### # # ##### # ####### ######### #
#         #         #       #   # #     # # # # # #     #   #
# ### ### # ############### # ######### ### # # # # # # # # #
#   #   # #             #       #           #       # #   #$#
#############################################################
